02/07/2025
trousers - quần tây
suppose - đáng lẽ ra
ago - trước đó
comfortable - thoải mái
Maybe - có lẽ
something - cái gì đó
better - tốt hơn
smart - thông minh
try - thử
decide - quyết định
few - một vài
interesting - thú vị
tight - chật
opinion - ý kiến
suggestion - gợi ý
another - một cái khác
other - nhiều cái khác
decade - thập kỷ (10 năm)
common - thường gặp
outfit - bộ trang phục
loose - lỏng lẻo
flare - phùng lên
lotus - hoa sen
collar - cổ áo
vintage - cổ điển
develop - phát triển
musician - nhạc sĩ
praise - ca ngợi
nation - quốc gia
technology - công nghệ
at that time - trong thời gian đó
more - hơn
basic - đơn giản
television - tv
become - trở thành
for instance - ví dụ
thing - đồ vật
such as - ví dụ
tug of war - kéo co
massive - to
teenager - thanh thiếu niên
fact - sự thật
century - thế kỷ (100 năm)
period - chu kỳ
period - tiết học
fashionable - hợp thời trang
young - trẻ
gadget - dồ tiện ích
heading - tiêu đề
text - chữ
sensation - cảm giác
sight - nhìn
smell - hửi
taste - nếm
touch - chạm
sound - âm thanh
visual - liên quan đến tầm nhìn
person - con người
choice - quyết định
sense - giác quan
most - nhiều nhất
important - quan trọng
