15072025
land - đất liền
adventure - cuộc phiêu lưu
find - tìm kiếm
place - chỗ
competition - cuộc thi
quiz - câu đố
chance - cơ hội
scuba_diving - lặn cùng với bình dưỡng khí
enormous - to lớn
deep - sâu
valley - thung lũng
river - dòng sông
spectacular - đáng ngưỡng mộ
fall - thác nước
fall - mùa thu
fall - rơi
wild - hoang dã
wildlife - cuộc sống hoang dã
forest - rừng
rainforest - rừng mưa
cave - hang động
hold - cầm
largest - lớn nhất
natural - tự nhiên
volume - thể tích
volume - âm lượng
surf - lướt sóng
wave - sóng
ocean - biển
competitor - người tham gia thi đấu
through - băng qua
dune - cồn cát
desert - sa mạc
race - cuộc đua
part - một phần
challenge - thử thách
include - bao gồm
dream - mơ
national - quốc gia
volcano - núi lửa
prefer - thích hơn
