ietls writing của Nhi
significant - quan trọng, đáng kể
essential - thiết yếu
crucial - then chốt
major - chính, chủ yếu
considerable - đáng kể
primary - chính, nguyên thủy
key - then chốt
fundamental - cơ bản, nền tảng
important - quan trọng
vital - sống còn
beneficial - có lợi
valuable - có giá trị
advantageous - có lợi thế
positive - tích cực
favorable - thuận lợi
negative - tiêu cực
harmful - có hại
damaging - gây tổn hại
detrimental - bất lợi
problematic - có vấn đề
widespread - lan rộng
common - phổ biến
prevalent - thịnh hành
frequent - thường xuyên
ordinary - thông thường
increase - tăng lên
grow - phát triển
rise - tăng
expand - mở rộng
improve - cải thiện
enhance - nâng cao
develop - phát triển
decrease - giảm xuống
decline - suy giảm
reduce - giảm
drop - rơi xuống
solution - giải pháp
method - phương pháp
approach - cách tiếp cận
strategy - chiến lược
paramount - tối quan trọng
indispensable - không thể thiếu
integral - thiết yếu, gắn liền
conducive - tạo điều kiện thuận lợi
adverse - bất lợi, tiêu cực
viable - khả thi
implement - triển khai, thực hiện
advocate - ủng hộ, tán thành
compelling - hấp dẫn, thuyết phục
priority - ưu tiên
