Từ vựng Bài 1
App - ứng dụng
Craze - cơn sốt trên mạng xã hội (dài)
Fad - cơn sốt trên mạng xã hội (ngắn)
Follower - người theo dõi
Gadget - đồ dùng tiện ích
Post (n) - bài đăng
Post (v) - đăng
Social media - mạng xã hội
interested in - thấy thú vị
into - thích
spend - tiêu xài
crazy about - thích điên cuồng về ...
generally - nói chung
young - trẻ
obviously - dĩ nhiên
strange - lạ
probably - có lẽ
pole - cột
amazingly - một cách tuyệt vời
popular - nổi tiếng
record - kỷ lục
record - quay phim này
current - hiện tại
card - thẻ
collect - thu thập
idea - ý tưởng
quick - nhanh chóng
absolutely - chính xác/tuyệt đối
become - trở thành
before - trước đó
be used to + ving - thói quen cũ
score - ghi điểm
immediately - ngay lập tức
rock - cục đá
sell - bán
instructions - hướng dẫn sử dụng
apparently - hiện tại
sold - bán (quá khứ)
million - triệu
no one - không ai
really - thực sự
know - biết
next - kế tiếp
information - thông tin
digital - điện tử
product - sản phẩm
best - nhất
compete - thi đấu
for - cho
prize - giải thưởng
