hai binh sieu dep chai
Aerial rivers - Sông khí quyển (luồng hơi ẩm cực lớn)
Bomb cyclone - Bão nổ (áp thấp tăng cường nhanh)
Cryovolcanoes - Núi lửa băng (phun trào chất băng)
Derecho complex - Hệ thống bão thẳng quy mô lớn
Frost quakes - Động đất băng (tiếng nổ do băng co giãn)
Glacier blood - Hiện tượng tảo đỏ trên sông băng
Hypercanes - Siêu bão (giả thuyết bão cấp độ vũ trụ)
Ice tsunamis - Sóng thần băng (băng tràn vào đất liền)
Jupiter storms - Bão kiểu Sao Mộc (xoáy cực dài)
Katabatic bursts - Gió trọng lực tốc độ cao
Lightning sprites - Tia sáng đỏ trên tầng điện ly
Mammatus clouds - Mây vú (mây hình túi kỳ dị)
Noctilucent clouds - Mây dạ quang (phát sáng ban đêm)
Ozone mini-holes - Lỗ ozone tạm thời
Pyrocumulonimbus - Mây giông lửa (do cháy rừng)
Quantum weather - Thời tiết lượng tử (dự báo bằng cơ học lượng tử)
Raining spiders - Hiện tượng nhện rơi từ trời
Sting jets - Luồng gió lạnh cực mạnh trong bão
Thundersnow - Sấm tuyết (hiếm gặp)
Undular bores - Sóng khí quyển hình ống
Vortex streets - Đường phố xoáy (dãy xoáy khí quyển)
Waterspout alleys - Vùng lốc nước thường xuyên
Xenon flashes - Chớp tia X (trong dông sét)
Yellow snow - Tuyết vàng (do phấn hoa/bụi sa mạc)
Zonal winds - Gió vành đai (luồng gió xoay quanh hành tinh)
Algorithmic colonialism - Chủ nghĩa thực dân thuật toán
Bio-fascism - Chủ nghĩa phát xít sinh học
Climate apartheid - Phân biệt đối xử khí hậu
Deepfake democracy - Nền dân chủ giả mạo sâu
Eco-anxiety - Lo âu sinh thái
Fentanyl crisis - Khủng hoảng thuốc giảm đau gây nghiện
Ghost flights - Chuyến bay ma (bay không hành khách)
Hydrogen geopolitics - Địa chính trị hydro
Infodemic - Đại dịch thông tin sai lệch
Junk science - Khoa học rác (nghiên cứu giả)
Kleptocrypto - Trộm cắp tiền mã hóa
Liquid surveillance - Giám sát lỏng (theo dõi đa phương tiện)
Microtargeting - Tiếp thị vi mô (thao túng cá nhân)
Neurocapitalism - Chủ nghĩa tư bản khai thác não bộ
Omnicrisis - Khủng hoảng toàn diện
Pharmageddon - Thảm họa dược phẩm (kháng thuốc)
Quantum espionage - Gián điệp lượng tử
Ransomware pandemics - Đại dịch mã độc tống tiền
Shadow banning - Cấm ngầm (trên mạng xã hội)
Technofeudalism - Chế độ phong kiến công nghệ
Urban heat islands - Đảo nhiệt đô thị
Vigilante AI - Trí tuệ nhân tạo tự xử
Water wars - Chiến tranh nguồn nước
Xenotransplantation - Cấy ghép nội tạng động vật sang người
Zero-day economy - Kinh tế khai thác lỗ hổng chưa vá
