A multicultural world
multiculturalism - chủ nghĩa đa văn hóa
pluralistic - [thuộc về] đa nguyên
diversity - sự đa dạng
assimilation - sự đồng hóa
integration - sự hội nhập
coexistence - sự chung sống
cosmopolitan - thuộc về toàn cầu, đa văn hóa
global_village - ngôi làng toàn cầu
interconnected - kết nối với nhau
acculturation - sự tiếp biến văn hóa
ethnicity - dân tộc, sắc tộc
heritage - di sản
custom - phong tục
tradition - truyền thống
tolerance - sự khoan dung
inclusivity - sự bao dung, tính bao trùm
harmony - sự hài hòa
discrimination - sự phân biệt đối xử
prejudice - định kiến
stereotype - khuôn mẫu
xenophobia - chứng sợ người nước ngoài
intercultural - liên văn hóa
cross-cultural - giao thoa văn hóa
emigration - sự di cư (ra khỏi nước)
immigration - sự nhập cư (vào một nước)
diaspora - cộng đồng kiều bào
expatriate - người định cư ở nước ngoài
nationalism - chủ nghĩa dân tộc
patriotism - lòng yêu nước
cultural_norms - chuẩn mực văn hóa
ethnocentric - duy chủng tộc
secular - thế tục
multilingual - đa ngôn ngữ
bilingual - song ngữ
linguistic - thuộc về ngôn ngữ
homogeneous - đồng nhất
heterogeneous - không đồng nhất, đa dạng
mosaic - bức tranh khảm
fusion - sự kết hợp, hòa trộn
amalgamation - sự hợp nhất
disparity - sự chênh lệch
marginalization - sự gạt ra bên lề
celebrate_diversity - tôn vinh sự đa dạng
cultural_awareness - nhận thức về văn hóa
sensitivity - sự nhạy cảm (văn hóa)
enrich - làm giàu, làm phong phú
synergy - sự cộng hưởng
transcend - vượt qua, siêu việt
ubiquitous - có mặt ở khắp mọi nơi
unifying - thống nhất, gắn kết
