29/06/2025
office - văn phòng
fashion - thời trang
identify - nhận diện
someone - ai đó
personality - tính cách
interests - sở thích
wear - mặc
spring - xuân
summer - hạ
fall - thu
autumn - thu
winter - đông
believe - tin
contact - liên lạc
baggy - rộng thùng thình 
blouse - áo khoác ngoài
indigo - màu chàm
pattern - họa tiết
trainers - giày thể thao
shirt - áo thun
knee_length - dài đến đầu gối
skirt - váy
scarf - khăn choàng
trousers - quần tây
shorts - quần ngắn
carry - cầm
shop (v) - mua hàng
steal -cướp
purse - ví của phụ nữ
notice - chú ý
shine - tỏa sáng
yesterday -hôm qua
sun - mặt trời
wait - chờ
rule - luật lệ
action - hành động
simultaneous - liên tục
continuous - liên tiếp
interrupt - cắt ngang
outside - bên ngoài
accident - tai nạn
cycle - đạp xe đạp
phone (v) - gọi
celebrate - ăn mừng
