Trạng Từ Chỉ Tần Suất - Adverbs of Frequency
always - luôn luôn
never - không bao giờ
usually - thường xuyên
sometimes - thỉnh thoảng
often - thường xuyên
rarely - hiếm khi
frequently - thường xuyên
occasionally - thỉnh thoảng
seldom - ít khi
constantly - liên tục
regularly - đều đặn
hardly ever - hầu như không bao giờ
almost always - hầu như luôn luôn
almost never - hầu như không bao giờ
every day - mỗi ngày
every week - mỗi tuần
every month - mỗi tháng
every year - mỗi năm
once - một lần
twice - hai lần
three times - ba lần
daily - hàng ngày
weekly - hàng tuần
monthly - hàng tháng
yearly - hàng năm
hourly - mỗi giờ
repeatedly - lặp đi lặp lại
continuously - liên tục
periodically - định kỳ
sporadically - thất thường
intermittently - ngắt quãng
